12111111111111111111
10101010001010111001
10000010111010001011
11111010001110101001
10100000111010000001
10110111101011011101
10000001001000000101
11011110101101111011
10000101101000010111
10101110000010111001
10100010100010001011
11111010010001101001
10100000101010000001
10110111101011011101
10000001011000000101
11011110001101011011
10000101000000010111
10100000111010000111
10110100001011010001
11111111111111111131
